1111111111111111
1P00000000000001
1111111011111111
1CCC000000000011
1111111E11111001
1111111011111011
1111111011111011
1000C00000000011
1111111111111111