11111111111111111111111111111111111111111111
1C000000000000000000001000000000000000000001
11111111011111111111101011111111111111111101
1000000101000000000C101000000000000000000101
101C00C10101111111111010011111101111101111E1
10111111010100000000101001000C101C0010100111
100000000001P11111101000000000101000000000C1
11111111011111000000111111111110101111111111
1C0000000100000111100000000000001000000000C1
11111111111111111111111111111111111111111111