111111111111111111111111111111111111
1C0000000000000000000000000000000P01
111111110111111111111111111111111111
1000000001C00000000000000000100000C1
100000000001111111111111111000111111
111111111011111111111111111111111111
1111111110000000000000000000000000E1
111111111111111111111111111111111111