WE sprites/64/wallw.xpm
EA sprites/64/walle.xpm
NO sprites/64/walln.xpm
SO sprites/64/walls.xpm

F 255,100,0
C 225,30,0

11111111111111111111111111111
11110111111111011101010010001
11000000110101011100000010001
10000000000000000000000000001
100000000E00000011010100100001
1100000111010101111101111000111
11110111 1110101 101111010001
11111111 1111111 111111111111